#####################
# P #               #
#   # ###########   #
#   #               #
#   #####      ######
#          ##       #
#   ##############  #
#   #####           #
#   #         #######
############     #  #
#                #  S
#   ##############  #
#                   #
#####################
